[
[-1,0,-1,-3,500,0,0,0,0,-3,0,0,0,0,500,-1,0,0,0,0,0],
[350,0,0,0,0,-3,-3,0,0,0,0,0,0,200,-2,0,0,0,0,0,0],
[0,0,-2,550,0,-2,0,-2,0,0,0,-2,-1,0,700,650,0,550,-3,100,-2],
[0,0,0,0,150,0,0,-2,500,0,0,0,0,700,700,150,0,-1,0,0,0],
[0,0,0,0,0,-3,0,0,0,0,0,0,0,-2,0,0,0,0,0,0,0],
[50,0,0,-2,0,400,200,0,0,0,0,0,0,0,-3,0,-2,-3,0,0,0],
[0,0,0,0,0,0,-1,0,0,0,0,0,0,-3,0,0,-1,-2,-3,0,0],
[0,0,0,0,0,0,100,-2,0,0,0,-3,0,0,0,0,0,-3,0,-3,0],
[0,-1,-2,-1,0,0,700,0,0,0,0,0,-3,0,-3,0,0,0,0,0,50]
]

