[[50,-2,-3,0,0,0,50,-3,-1,-1,-3,-1,0,-2,-3,-3,50,-3,0,-3,-3],
[0,-1,-1,50,-2,-3,50,-3,0,-2,-3,0,0,0,-2,-2,0,0,0,-3,50],
[-2,-1,0,50,0,-2,-3,-2,-1,-1,-2,50,-3,50,0,-3,-2,-1,0,-1,0],
[0,0,-1,-3,0,0,-3,50,-2,-2,-1,-2,-3,0,0,-3,-1,-2,0,-3,-1],
[50,0,-3,-2,-1,-2,-1,-2,-3,50,0,0,-2,0,-3,50,-1,-3,-3,50,-1],
[-1,-3,-1,-2,-2,-3,-2,0,-2,-3,0,0,0,-2,-2,0,0,0,-2,-1,50],
[50,-3,50,-3,-1,-3,-2,0,-3,-3,50,-1,-2,-1,-2,-2,0,0,-3,0,0],
[0,-2,0,-1,0,-3,-2,-2,-1,-2,0,0,-3,-2,50,0,-3,-2,-3,-2,-3],
[-1,-3,-2,-3,0,-3,50,-1,0,0,-2,-3,50,0,-2,0,0,0,50,-1,0]]